1111111111111
1E0000C011111
11110000P0111
10C0000111111
1111111111111