11111111111111111111111111111111
1E000011110000000100000C0001C1P1
11C000011100111C0101011111000101
11111000000C111000010C0000010001
11111111111111111111111111111111