1111111111111111111111111111111111
1E0000000000000C000001000C00000001
1110C1010010000010100100000001C101
1C11110010101010001001000100010101
1P0000000000C0000000000001000000C1
1111111111111111111111111111111111