11111111111111111111111111111111111111
100000000000000000000000111111110000E1
10011111111000000000000011111111000001
1001000C1110000111111100C1111111000001
100100001110000111P111000111110C000001
10000000111000011101110000111100000001
11111110111100000001110000000000010001
11111C0011111C0000011100000000C00100C1
11111111111111111111111111111111111111