1111111111111111111111111111111111111111
10C0011110010000C1111000100C11111111C111
1111011100000100111000000011111111000111
10000000000000000000000000000000000E0111
1011111111000100000000111110000100100111
1000010111100000000010101111111000000111
1000111111111111000000001100000001000111
10P0000000000000000000000000000000000111
1000001111100000111111000001000001111111
1111100000001111100000000011111000000111
1000000000000000000011100000000000000111
1000011111100000001111001110110101010111
1000111111111000000111111110000001010111
1000000000000000000000000000000000100111
1000011100011000000011111111111110111111
1111111000000000000000000000111111111111
1C000000111111111111111111100000000000C1
1111111000000000100000000000011111111111
11111111C1111111111111111111111111111111
1111111000000000011111111111111111111111
1111111111111111111111111111111111111111